50,-50,51,-50,51,50,50,50
-51,-50,-51,-55,51,-51,51,-50
-50,50,-51,50,-51,-50,-50,-50
-51,51,-51,50,51,50,51,51
-20,-20,30,-20,30,30,-20,30
