50,-50,51,-50,51,50,50,50
-51,-50,-51,-55,51,-51,51,-50
-50,50,-51,50,-51,-50,-50,-50
-51,51,-51,50,51,50,51,51
-50,25,10,25,10,35,-50,35
-20,0,50,0,50,10,-20,10
-20,-30,-10,-30,-10,0,-20,0
10,-50,20,-50,20,-20,10,-20
