20,-20,21,-20,21,20,20,20
-21,-20,-21,-21,21,-21,21,-20
-20,20,-21,20,-21,-20,-20,-20
-21,21,-21,20,21,20,21,21
-8,-8,8,-8,8,8,-8,8
